##############
#          ###
# ## # ###   #
# ##    #### #
# ## ##      #
# #   # #### #
#   # #   ## #
# ###   # ## #
#     ###    #
##############
